100000001
110000011
110000011
100000001
100000001
100000001
110000011
111000111
111000111
111000011
100000001
111000111
100000001
100000111
100000001
