000000000
110000011
111000111
110000011
000000000
110000011
000000000
111111000
000011000
111011000
000000000
110000011
000000000
111000111
111000111
111000111
000000000
111111000
000011000
111011000
000000000
000000000
111000111
111000111
111000111
111000111
111000111
111000111
000000000
101111111
000000000


